A=======*#*==#===
=$#=#===*==#*=*#*
=##==@==*=#*=#=#=
===A==@=*=*#==*==
=#==####A####=#**
==@=#=*===*=###=*
===@#=M=*=M=#*===
====#*=***=*#=###
****A==*M*==B****
###=#*=***=*#====
===*#=M=*=M=#@===
*#=##=*===*=#=@==
**#=####B####==#=
=====#*=*=@==B===
*#*#=*#=*==@==##=
=#==*#==*===#=#$=
==*#==*#*=======B


1  F标志
2  =道路
3  *可炸毁
4  #不可炸毁
5  $家
6  H英雄复活位置
7  @夹子
8  M怪兽
9  A只允许A通过
10 B只允许B通过