17 17
F=======*#*==#===
=$#=#===*==#*=*#*
=##==@==*=#*=#=#=
===H==@=*=*#==*==
=#==####A####=#**
==@=#=*===*=###=*
===@#=M=*=M=#*===
====#*=***=*#=###
****A==*M*==B****
###=#*=***=*#====
===*#=M=*=M=#@===
*#=##=*===*=#=@==
**#=####B####==#=
=====#*=*=@==H===
*#*#=*#=*==@==##=
=#==*#==*===#=#$=
==*#==*#*=======F


F标志
=道路
*可炸毁
#不可炸毁
$家
H英雄复活位置
@夹子
M怪兽
A只允许A通过
B只允许B通过